1111111111111
1P0000000001
1000100X0001
10001X1C0001
1000100C0001
1000X0X00001
1000C000C001
10000X0X0001
1000000E0001
1111111111111
