11111111111111
1P0X00000E001
10C000000C001
100000000X001
1000C0000C001
10000000X0001
11111111111111
