1111111111111111111
1000000000000000E1
1000000000000000C1
1000000000000000X1
1000000000000000C1
1000000000000000X1
1000000000000000C1
10000000P0000000X1
1111111111111111111
