11111111111111111
1E0000000000001
101010101010101
1P1010101010101
101010101010101
1C1010101010101
1X1010101010101
1C1010101010101
1X1010101010101
1C000X0000C1001
11111111111111111
