1111111111111
1P0000000C001
1011111101011
1000000000C01
1011111111011
1000000000E01
1111111111111
