1111111111111111111111
1P000C00000000C0000001
1011101010111011111011
1000X01010000010000C01
1110111011111010111111
100C000X00001010000001
1011111101011011111011
1000000101000000C00001
1111101010111110111011
100000101000X010000001
1010111011111011101111
1000100000C00001000C01
1111101111101111111011
1000000000X000000000E1
1111111111111111111111
