1111111
1P0C01
10X0E1
1111111
