1111111111111
1000010000001
1P0C010X00E01
1000010000001
1111111111111
