1111111111111
1P00000000001
1000000000001
100C00X0C0001
1000000000001
1000000000001
100C00000C001
1000000000001
100000X000001
100000000E001
1111111111111
